15 15
000110000000000
001001000011100
001000100100100
000110011000100
000001111111000
000000011000000
011111101111110
011111101111110
011111101111110
011111101111110
000000000000000
011111101111110
011111101111110
011111101111110
011111101111110
