10 30
0001111100
0011000110
0010010010
0010001010
0011001010
0001110010
0000000110
0000001100
0000011000
0000110000
0011111000
0111111100
1111111110
1111111111
1111111111
1011111101
0100000010
0111111110
1111111111
1111111111
1110010011
1110111011
0111101110
1111111111
1100000111
0011101000
0111110110
0111110001
0111110011
0011101110
