8 8
 OOXXXXOO
OOOOOOOO
XOOOOOOX
XOXOOXOX
XOOOOOOX
XOOXXOOX
XXOOOOXX
XXXXXXXX