12
15
XXXXOOOOXXXX
XXXOOOOOOXXX
XXXOOOOOOXXX
XXXOOXXOOXXX
XXXOOXXXOOXX
XXOOXXXXOOXX
XXOOXXXXXOXX
XXOOXXXXXOXX
XXOOXXXXXOXX
XXOOXXXXXOXX
XXOOXXXXXOXX
XXOOXXXXXOXX
XXOOXXXXXOXX
XXOOXXXXOOXX
XXXOOOOOOXXX