13
9
XXXXXXOXXXXXX
XXXXOOOOOXXXX
XXXOOOOOOOXXX
XXXXOOOOOXXXX
XOOOOOOOOOOOX
OOOOOOOOOOOOO
OOOOOOOOOOOOO
OOOOOOOOOOOOO
OOOOOOOOOOOOO