14
7
XXXXOOOOOOXXXX
OOOOOXXXXOOOOX
OOXXXXXXXXXXOO
XOOOXOOOOXOOOX
XXXOXOOOOXOXXX
XXXOOOOOOOOXXX
XXXOOOOOOOOXXX