12
8
XXXXXXXXXXOO
XXXXXXXXOOOO
XXXXXXOOOOOX
XXXXXOOOXOOX
OOXXXOOXXOOX
OOOOOOXXOOXX
XOOXXXOOOXXX
XXOOOOOXXXXX