15
8
XXXXXXXXXOOXXXX
XXXXXXXXXOXXXOX
XXXXXXXOOXXXOOX
XXXXXXOOXOOOXXX
XXXXXOXXOOXXXXX
XXXXOXOOXXXXXXX
XXOOXOXXXXXXXXX
XOXOXXXXXXXXXXX