7
7
XOXOXOX
XOXOXOX
XOXOXOX
XOOOOOX
XXXOXXX
XXXOXXX
XXXOXXX