14
11
OOOOOOOOOOOOOO
OOOXXXXXXXXXXO
OOOOOOOOOOOOOO
OOXXXXXXOOOOXO
OOXXXXXXXXXXXO
OOXXXXXXXXXXXO
OOXXXXXXXXXXOO
OOXXXXXXXXXXOO
OOXXXXXXXXXXOO
OOOOOOOOOOOOOO
XOOOOOOOOOOOOX