8
10
XXOXXXXX
XXOOXXXX
XXOOOXXX
XXOOOXXX
XXOOOXXX
XXOOXXXX
XXOXXXXX
XXOXXXXX
XXOXXXXX
XXOXXXXX