10
9
XXXXXOXXXX
XXXXOOOXXX
XXXOOOOOXX
XXXOOOOOXX
XXOOOOOOXX
XXOOOOOXXX
XXXOOOOXXX
XXXXOOOXXX
XXXXXOXXXX