8
7
OOOOOOOO
OXXXXXXO
OXOOOOXO
OXXXXXXO
OXOOOOXO
OXXXXXXO
OOOOOOOO