8
6
OOOOOOOO
XOOXOOOX
XXOOXOXX
XXXOOXXX
XOXXOXXX
XXXOXXOX