8
8
XXXXXXXX
XXXOOXXX
XOOOOOOX
OOOOOOOO
XOOOOOOX
XOOOOOOX
XOOOOOOX
XXXXXXXX