12
9
XXXOOOOOOXXX
XXOOOOOOOOXX
XXXOOOOOOXXX
XXOOOOOOOOXX
XOOXXXOXXOOX
XOOXXXOOXOOX
XOOXXXOOXXOX
OOXXXXXOXXOO
OOOOOOOOOOOO