12
5
XXOOOOOOOOXX
XOOOOOOOOOOX
XOXXXXXXXXOX
XOOOOOOOOOOX
XXOOOOOOOOXX