9
12
XOOOOOOOX
OXOXOXOXO
OXOXOXOXO
OXOXOXOXO
XOXXXXXOX
XXXOXOXXX
XXXOXOXXX
XXXOXOXXX
XXXOXOXXX
XXXOXOXXX
XXOOXXOXX
XXXOOOXXX