7
9
XXOOOXX
XOOOOOX
OOOOOOO
XOOOOOX
XXOOOXX
XXXOXXX
XXXOXXX
XXXOXXX
XXXOXXX