8 8
00000000
00011000
01111110
11111111
01111110
01111110
01111110
00000000