25 25
1111111111111111111111111
1000000000000000000000001
1000000000000000000000001
1000000000000000000000001
1000000000000000000000001
1000000000000000000000001
1001100000000000000000001
1001110000000000000001101
1001111000000000000011101
1001111100000000000111101
1001111110000000001111101
1001111111000000011111101
1000111111100000111111101
1000011111110000111111001
1000001111111000111110001
1000000111111100000000001
1000000011111110000000001
1000000001111111000000001
1000000000111111000000001
1000000000000000000000001
1000000000000000000000001
1000000000000000000000001
1000000000000000000000001
1000000000000000000000001
1111111111111111111111111
