20 20
 OOOOOOXXXXXXXXXXXXOOOOOOOOOOOOOXXXXXXXXXXXXOOOOOO
OOOOOOXXXXXXOOOOOOOOOOOOOOOOOOOOOOOOOXXXXXXOOOOOO
OOOXXXXXXXXXOOOOOOOOOOOOOOOOOOOOOOOOOXXXXXXXXXOOO
OOOXXXXXXXXXXXXXXXOOOOOOOOOOOOOXXXXXXXXXXXXXXXOOO
OOOXXXXXXXXXXXXXXXOOOOOOOOOOOOOXXOXXXXXXXXXXXXOOO
XXXXXXXXXXXXXXXOOOOOOOOOOOOOOOOOOOXXXXXXXXXXXXXXX
XXXXXXOOOOOOOOOOOOOOOOOOOOOOOOOOOOOOOOOOOOOXXXXXX
XXXXXXOOOOOOOOOOOOOOOOOOOOOOOOOOOOOOOOOOOOOXXXXXX
XXXXXXOOOOOOXXXXXXXXXXXXXXXXXXXXXXXXXOOOOOOXXXXXX
XXXXXXXXXXXXXXXXXXXXXXXXXXXXXXXXXXXXXXXXXXXXXXXXX
XXXXXXXXXXXXXXXXXXXXXXXXXXXXXXXXXXXXXXXXXXXXXXXXX
OOOXXXXXXXXXXXXXXXXXXXXXXXXXXXXXXXXXXXXXXXXXXXOOO
OOOOOOOOOXXXXXXXXXXXXXXXXXXXXXXXXXXXXXXXOOOOOOOOO
OOOOOOOOOXXXXXXXXXXXXXXXXXXXXXXXXXXXXXXXOOOOOOOOO
OOOXXXXXXXXXXXXXXXXXXXXXXXXXXXXXXXXXXXXXXXXXXXOOO
XXXXXXOOOOOOXXXXXXXXXXXXXXXXXXXXXXXXXOOOOOOXXXXXX
XXXXXXOOOOOOXXXXXXXXXXXXXXXXXXXXXXXXXOOOOOOXXXXXX
OOOOOOOOOXXXXXXXXXXXXXXXXXXXXXXXXXXXXXXXOOOOOOOOO
OOOOOOOXXXXXOOOOOOXXXXXXXXXXXXXOOOOOOXXXXXOOOOOOO
OOOOOOXXXXXXOOOOOOOXXXXXXXXXXXXOOOOOOXXXXXXOOOOOO