20 20
 XXXXXXXXXXXXXXXXXXXXXXXXXXXXXXXXXXXXXXXX
XXXXXXXXXXXXXXXXXXXXXXXXXXXXXXXXXXXXXXXX
XXXXXXXXXXXXXXXXXXXXXXXXXXXXXXXXXXXXXXXX
XXXXXXXXXXXXXXXXXXXXXXXXXXXXXXXXXXXXXXXX
XXXXXXXXXXXXXXXXXXXXXXXXXXXXXXXXXXXXXXXX
XXXXXXXXXXXXXXXXXOXXXXOXXXXXXXXXXXXXXXXX
XXXXXXXXXXXXXXXXXXOXXOXXXXXXXXXXXXXXXXXX
XOOOOOOOOOOOOXXXXXXOOXXXXXXOOOOOOOOOOOOX
OOOOOOOOOOOOXOOOOXOOOOXOOOOXOOOOOOOOOOOO
OOOOOOOOOOOOOOOOOOOOOOOOOOOOOOOOOOOOOOOO
XOOOOOOOOOOXOOOOOOOOOOOOOOOOXOOOOOOOOOOX
XXXOOOOOOOOOOOOOOOOOOOOOOOOOOOOOOOOOOXXX
XXXXXXOOOOOOOOOOOOOOOOOOOOOOOOOOOOXXXXXX
XXXXXXXXOOOOOOOOOOOOOOOOOOOOOOOOXXXXXXXX
XXXXXXXXXOOOOOOOOOXXXXOOOOOOOOOXXXXXXXXX
XXXXXXXXXXOOOOOOOXXXXXXOOOOOOOXXXXXXXXXX
XXXXXXXXXXXXXXXXXXXXXXXXXXXXXXXXXXXXXXXX
XXXXXXXXXXXXXXXXXXXXXXXXXXXXXXXXXXXXXXXX
XXXXXXXXXXXXXXXXXXXXXXXXXXXXXXXXXXXXXXXX
XXXXXXXXXXXXXXXXXXXXXXXXXXXXXXXXXXXXXXXX