20 20
XXXXXXXXXXXXXXOOOOXX
XXXXXXXXXXXXXOOXOXOX
XXXXXXXXXXXXOOOXXOOO
XXXXXXXXXXOOOOOOOOOO
XXXXXXXXXOOXXOOOOXOO
XXXXXXXXOOOOXXOOXXOX
XXXXXXXOOOOOOXOOXXXX
XXXXXXOOOOOOOXOOXXXX
XXXXXXOOOOOOOXOXXXXX
XXXXXOOOOOOOXOOXXXXX
XXXXXOOOOOOXOOXXXXXX
XXXXOOOOOOXOOXXXXXXX
XXXXOOOOOXOOXXOOOOOO
XXXOOOOOOOOOXOOOOOOO
XXOOOOOOOOXOOOOXXXXX
XOOOXOOOXOOOOOXXXXXX
OOXXOOOXXXOOXOXXXXXX
XXXXOOXXXOOOXXXXXXXX
XXXXOXXXOOXXXXXXXXXX
XXXXXXXOOXXXXXXXXXXX
