20 20
 XXXXXXXXXXXXXXXXXXXXXXXXXXXXXX
XXXXXXXXXXXOOOOOOOOXXXXXXXXXXX
XXXXXXXXOOOOOOOOOOOOOOXXXXXXXX
XXXXXXXXOOXOOXOOXOOXOOXXXXXXXX
XXXXXXXXOOXXXOOOOXXXOOXXXXXXXX
XXXXXXXXOOXXOOOOOOXXOOXXXXXXXX
XXXXXXXXOOOXXXXXXXXOOOXXXXXXXX
XXXXXXOOOOOOOXXXXOOOOOOOXXXXXX
XXXXXXOOOOOXXXXXXXXOOOOOXXXXXX
XXXXXOOOOOOXXXXXXXXOOOOOOXXXXX
XXXXOOOOOOOXXXXXXXXOOOOOOOOXXX
XXXOOOOOOOOXXXXXXXXOOOOOOOOXXX
XXOOOOOOOXXXXXXXXXXXXOOOOOOOXX
XXOOOOOOOXXXXXXXXXXXXOOOOOOOXX
XXOOOXOOOXXXXXXXXXXXXOOOXOOOXX
XXXXXXOOOOXXXXXXXXXXOOOOXXXXXX
XXXXXXOOOOOOXXXXXXOOOOOOXXXXXX
XXXXXXXXOOOOOOOOOOOOOOXXXXXXXX
XXXXXXXXOOOXXXXXXXXOOOXXXXXXXX
XXXXXXXXXXXXXXXXXXXXXXXXXXXXXX