9 12
011111110
101010101
101010101
101010101
010000010
000101000
000101000
000101000
000101000
000101000
001100100
000111000