10 9
0000010000
0000111000
0001111100
0001111100
0011111100
0011111000
0001111000
0000111000
0000010000