12 5
001111111100
011111111110
010000000010
011111111110
001111111100