12 9
000111111000
001111111100
000111111000
001111111100
011000100110
011000110110
011000110010
110000010011
111111111111