14 7
00001111110000
11111000011110
11000000000011
01110111101110
00010111101000
00011111111000
00011111111000