13 13
 XXXXXXXXXXXXX
XXOOXXXXXXXXX
XOOOOXXXXXXXX
OOOOOXXXXXXXX
XXOOOXXXXXXXX
XXOOOXXXXXXXX
XOOOXXXXXXXXX
XOOXXXXXXXXXX
OOOXXXOXXXOOO
OOXXXOOOXXOXO
OOXOOOOOOOXXO
OOOOOOOOOOOOO
XOOOXOOOXOOOX