13 13
1100000000011
1110000000111
0001000001000
0001000001000
0011100011100
0001000001000
1101000001011
1100000000011
0001000001000
0010111110100
0010000000100
0001111111000