13 13
0000000000000
0000000000000
0000010101000
0001101010100
0010101010100
0010101010100
0010101010110
0010101010101
0010101010111
0001111111101
0000000010001
0000000001111
0000000000000