23 23
00000000000000000000000
00000000000000000000000
00000000001000001000000
00000001001001001000000
00000011111111111100000
00001101001001001011000
00010001000001000000100
00011100000000000011100
00010011111111111100100
00010000000000000000100
00011000001111000001100
00010010010000100100100
00010111000000001110100
00011111100000011111100
00011111110000111111100
00011111111111111111100
00011111111111111111100
00001111111111111111000
00000011111111111100000