13 17
0000000011100
0000000010110
0000011110011
0001111110101
0011100010101
0010010011011
0011100111010
0111011011011
1100000000101
1011000011011
1010111101010
1110000001010
0110000001010
0110000001010
0101000010110
0100111100110
0011111111100