10 10
 XXXXXXXXXX
XXXXXXOOXX
XXXXXXXXOX
XXOOXXXXOX
XOXXXXOOXX
XOOXXXXXOX
XXXOXXXXOX
XXXXXXOOXX
XXXXXXXXXX
XXXXXXXXXX