15 15 
 XXXXXXOOOXXXXXX
XXXXXXXXXXXXXXX
XXXXOOXXXOOXXXX
XXXOXXXXXXXOXXX
XOOXOOXXXOOXOOX
OXXXOOXXXOOXXXO
OXXXOOXXXOOXXXO
OXXXXXXXXXXXXXO
OXXXXXOOOXXXXXO
XXXXXOXXXOXXXXX
XOXXXOOOOOXXXOX
XXXXXOOOOOXXOXX
XXXXXXOOOXXXXXX
XXXXOXXXXXOXXXX
XXXXXOOOOOXXXXX