15 15 
000111111111000
001000000000100
010000000000010
100111000111001
100101000101001
100101000101001
100111000111001
100000000000001
100000101000001
010000000000010
001100000001100
000010101010000
000010101010000
000010101010000
000011111110000