20 20
 XXXXXXXOOOXXXXXXXXXX
XXXXXXXOXOOXXXXXXXXX
XXXXXXXOXOOOXXXXXXXX
XXXXXXXOOOOOOXXXXXXX
XXXXXXOOOOOOOXXXXXXX
XXXXXOOOOOOOOOXXXXXX
XXXXXOXOOOOOOOOXXXXX
XXXXXOOOOOOOOOOXXXXX
XXXXXOXXOOOOXXOXXXXX
XXXXOXOOXOOXOOXOXXXX
XXXOOXOOXOOXOOXOOXXX
XXOOOXOOXOOXOOXOOXXX
XXOOOXOOXOOXOOXOOOXX
XXOOOOXXOXXOXXOOOOXX
XXOOOOOXXXXXXXOOOOXX
XOXXXXXXXXXXXXOOXXOX
XOOOOOOXXXXXXOOXOOOX
XOOOOOOOXXXXOOXOOOOX
XOOOOOOOOOOOXXOOOOOX
XXOOOOOOOOOOOOOOOOXX