20 20
 XXXXXXXXXXXXXXXXXXXX
XXXXXXXXXXXXXXXXXXXX
XXXXXXXXXXXXXXXXXXXX
XXXXXXXXXXXXXXXXXXXX
XXXXXXXXXXXXXXXXXXXX
XXOOXXXXXXXXXXXOOOXX
XOXXXXXXXXXXXXXXXXOX
XXXXXXXXXXXXXXXXXXXX
XXXXXXXXXXXXXXXXXXXX
XXXXXXXXXXXXXXXXXXXX
XOXXOXXXXXXXXXXXXXOX
XXOOXXXXXXXXXXXOXOXX
XXXXXXXXXOOXXXXXOXXX
XXOOXXXXOOOOXXXOXOXX
XOXXOXXXOXXOXXXXXXOX
XOXXXXXXOOOOXXXXXXOX
XXXXXXXXOOOOXXXXXXXX
XXXXXXXXXXXXXXXXXXXX
XXXXXXXXXXXXXXXXXXXX
XXXXXXXXXXXXXXXXXXXX