20 20 
 XXXXXXOOOXXXXXX
XXXXOOXXXOOXXXX
XXXOXXXXXXXOXXX
XXOXXXXXXXXXOXX
XOXXXXXXXXXXXOX
XOXXOOXXXOOXXOX
OXXXOXXXXXOXXXO
OXXXXXXXXXXXXXO
OXXXXXXXXXXXXXO
XOXXXOOOOOXXXOX
XOXXXXXXXXXXXOX
XXOXXXXXXXXXOXX
XXXOXXXXXXXOXXX
XXXXOOXXXOOXXXX
XXXXXXOOOXXXXXX