20 20
 XXXXXXXXXXXXXXXXXXXX
XXXXXXXXXXXXXXXXXXXX
XXXXXXXXXXXXXXXXXXXX
XXXXXXXOOOOOOXXXXXXX
XXXXXOOOXXXXOOOXXXXX
XXXXOOXXXXXXXXOOXXXX
XXXOOXXXXXXXXXXOXXXX
XXXOOOXXXXXOXXOOOXXX
XXXOXOXOOXXOOXOXOXXX
XXXOXOOOOXXOOOOXOXXX
XXXOOOOOOXOOOOOOOXXX
XXXOOOXXOOOXXXOOOXXX
XXXOOXXXXXXXXXXOOXXX
XXXOOXXXXXXXXXXOOXXX
XXXXOOXXXXXXXXOOXXXX
XXXXXOOOXXXXOOOXXXXX
XXXXXXXOOOOOOXXXXXXX
XXXXXXXXXXXXXXXXXXXX
XXXXXXXXXXXXXXXXXXXX
XXXXXXXXXXXXXXXXXXXX