10 10
 XXXXXXXXXX
XXXOOOOOXX
XXXXXXXXXX
XXXXXXXXXX
XXXXXXXXXX
XXXXXXXXXX
XOOOXXXOOX
XOOOXXXOOX
XXOXXXXOXX
XXXXXXXXXX