20 20
 OOOOOOOOOOOOOOOOOOOO
OOOOOOOXXXXXXOOOOOOO
OOOOOXXXXXXXXXXOOOOO
OOOOXXXXXXXXXXXXOOOO
OOOXXXXXXXXXXXXXXOOO
OOXXXXXXXXXXXXXXXXOO
OOXXXOOXXXXXXOOXXXOO
OXXXXXOOOXXOOOXXXXXO
OXXXXOOOOXXOOOOXXXXO
OXXXOOXXXXXXXXOOXXXO
OXXXXXXXXXXXXXXXXXXO
OXXXOOOOOOOOOOOOXXXO
OXXXOXXXXXXXXXXOXXXO
OOXXOOOOOOOOOOOOXXOO
OOXXXOOOOOOOOOOXXXOO
OOOXXOOOXXXXOOOXXOOO
OOOOXXOOOOOOOOXXOOOO
OOOOOXXXXXXXXXXOOOOO
OOOOOOOOXXXXOOOOOOOO
OOOOOOOOOOOOOOOOOOOO