10 10
 XXXXOOOOXX
XXXXOXXOOX
XXXXOXXXOO
OXXXOXXXOO
OXXXOOOOOX
XXXXOXXXXX
XXXXOXXXXX
XXXXOXXXXX
OOXXOXXXXX
XXXXXXXXXX