10 10
 XXXXXXXXXX
XXOXXXXXOX
XOOXXXXXOX
XXOXXXXXOX
XXXXXXXXXX
XXXXXXXXXX
XXXOOOOOXX
XXOXXXXOOX
XXXXXXXXOX
XXXXXXXXXX