10 10 
 XXXXXXXXXX
XXXXXXXOXX
XXXXXXOXXX
XXXOXXOXXX
XXXXXXOXXX
XXXXXOXXXX
XXXXXOXXXX
XXXOXOXXXX
XXXXXXXXXX
XXXXXXXXXX