15 15
 XXXXXOOOOOXXXXX
XXXOOXXXXXOXXXX
XXOXXXXXXXXOXXX
XOOXXXXXXXXXOXX
XOOOOOOOOOOOOXX
XOOOOOOOOOOOOOX
XOOXXOOXOXOOXOX
XOXOOOXXOOOOXOX
XOXXXXXXXXXXXOX
XOOXXXXXXXOXOXX
XXOXXOOOOOXXOXX
XXOOXXXXXXXOXXX
XXXOOXXXXOOXXXX
XXXXXOOOOXXXXXX
XXXXXXXXXXXXXXX