9 10
000010000
000010000
000101000
000110000
001001100
000111000
001110100
010101110
111011011
000010000