8 8
00010000
00001000
00011000
00111100
01111110
11111111
11111111
01111110