8 8
01110111
10011001
10011001
11011101
11011101
11011101
10011001
01110111