14 11
11111111111111
11100000000001
11111111111111
11000000111101
11000000000001
11000000000001
11000000000011
11000000000011
11000000000011
11111111111111
01111111111110