20 20
00000000000000000000
00000000000000000000
00000011111110000000
00001100000001100000
00010000010000010000
00010000010000010000
00010001111100010000
00010001010100010000
00010001010100010000
00010001010000010000
00010000111000010000
00010000010100010000
00010001010100010000
00010001010100010000
00010001111100010000
00010000010000010000
00010000010000010000
00001100000001100000
00000011111110000000
00000000000000000000