20 20
 XXXXXXXOOOOOOXXXXXXX
XXXXOOOOOOOOOOOOXXXX
XXXOOOOXXXXXXOOOOXXX
XXOOOXXXXXXXXXXXOOXX
XOOXXXXXXXXXXXXXXOOX
XOOXXXOXXXXXXOXXXOOX
OOXXXOOOXXXXOOOXXXOO
OOXXXOOOXXXXOOOXXXOO
OOXXXOOOXXXXOOOXXXXO
OOXXXXOXXXXXXOXXXXOO
OOXXXXXXXXXXXXXXXXXO
OOXXXOOOOOOOOOOXXXXO
OOXXOXXXOXXOXXXOXXOO
OOXXOOOOOOOOOOOOXXOO
XOOXOXXXOXXOXXXOXOOX
XOOXXOOOOOOOOOOXXOOX
XXOOXXXXXXXXXXXXOOXX
XXXOOOOXXXXXXOOOOXXX
XXXXOOOOOOOOOOOOXXXX
XXXXXXXOOOOOOXXXXXXX