20 20
00000000000000000000
00000011011000000000
00000100100100000000
00001000100010000000
00001000100010000000
00011100100111000000
00100110001100100000
01000011111000010000
01000001110000010000
00111101110111100000
01000001110000010000
01000011111000010000
00100110001100100000
00011100100111000000
00001000100011000000
00001000100011000000
00000100100101100000
00000011011001100000
00000000000001100000
00000000000001110000