20 20
00000000000000000000
00000000000000000000
00000011000000000000
00000111100000000000
00000111100000000000
00000011000000000000
00000010000000000000
00001010000000000000
00001010000000000000
00001011111000000000
00001010000000000000
00011110000000000000
00101111111110000000
01001111110001000000
01001111111100100000
01001111111110100000
01000110001000100000
00100000010000011000
00010000100000000000
00001111000000000000