17 23
00000111100000000
00000111110000000
00000011110000000
00000011110000000
00000000010000000
00001111111100000
00000011110000000
00000111111000000
00001101011100000
01010011111100000
01001111101100010
11000110011000010
01100001111000111
00101111111101100
00111110111111000
00011111111100000
00011110111100000
00111111111110000
00111110111110000
00011111111100000
00011111111100000
00001111111000000
00000011100000000