5 5
XOXOX
XOXOX
XOOOX
XOOOX
XXOXX