15 15
 XXXXXXXXXXXXXXXXXXXXXXXXXXXXXXXXXXXXXXX
XXXXXXXXXXXOOOOOOXXXXXOOOOOOXXXXXXXXXXX
XXXXXXXXXOOOOOOOOOOOOOOOOOOOOOXXXXXXXXX
XXXXXXXXXOOOXXXXOOOOOOOXXXOOOOXXXXXXXXX
XXXXXXXOOOOOXXOOOOOOOOOOOXXOOOOOXXXXXXX
XXXXXOOOOOOOXXOOOOOOOOOOOXXOOOOOOOXXXXX
XXXXXOOOOXXXOOOOOOOOOOOOOOOXXXOOOOXXXXX
XXXXXOOOOXXXOOOOOOOOOOOOOOOXXXOOOOXXXXX
XXXXXXXOOOOOOOOOOOOOOOOOOOOOOOOOXXXXXXX
XXXXXXXXXXOOOOOOOOOOOOOOOOOOOXXXXXXXXXX
XXOXXXOOOOOOOOOOOOOOOOOOOOOOOOOOOXXXXXX
XXOXXOOOOOOOOOOOOOXXXOOOOOOOOOOOOOXXXXO
OOXXXOOOOOOOOOOOOOXXXOOOOOOOOOOOOOXXXOO
OOXXXXXOOOOOOOOOOOOOOOOOOOOOOOOOXXXXOXX
XXOXXXXXXOOOOOOOOOOOOOOOOOOOOOXXXXXOOXX