15 15
000000110000000
000000011000000
000011111111100
001111111111010
011111111111101
111111111111111
111111101101111
111000011000110
110000000000010
100000000000000
110000000000011
010000011010101
000110110101100
001001101101110
111011101110111