15 15
000000000111000
000000001111100
000000011110111
000000011111110
000000001111100
000000000111000
000000001111100
100000111111110
111001110001110
111111101110110
011111011110110
011111111001100
001111111111000
000011011100000
000000111111000