15 15
000010100001010
001011100101110
000111110011111
000010110001011
000010000001000
000110000011000
000110000011000
001100000110000
001100000110001
111000111100111
111011111101111
110011111001111
011011111100101
001011010100001
001010010100111