15 15
000000000000111
000001111001101
000111001001010
111010011001000
110000010001100
011110011000110
000011001100011
000001000111001
000001100001101
000111100000111
000101001100011
000001001000010
000000101000010
000001111100110
000111011011100