15 15
XXXXXXXOOOOXXXX
XOOOOOOOXOXOXXX
OOXXXXXOOOXOXXX
OXXXXOOOXXXOXXX
OXOOOXXOXXOOOXX
OOOXXOOXOOXXXXX
XXXOOXXOXXOOOXX
XXOOXXOXOOXXOOX
XOXXXOOOXXXOXOO
XOXXOOXXXXOOXXO
XXOXXOOOOOOXXXO
XXXOOXXXXXXXOXO
XXXXXOOOOOOOOXO
OOXXXXXOXOXXXOO
OOOOXOOOOOOXXXX