15 15
000000011110000
011111110101000
110000011101000
100001110001000
101110010011100
111001101100000
000110010011100
001100101100110
010001110001011
010011000011001
001001111110001
000110000000101
000001111111101
110000010100011
111101111110000