20 20
00111000000000000000
11101100000000000000
11111100000000000000
00011110000000000000
11111110000000000000
00001111100000000000
00011111111000000000
00011111111100000000
00011110111110000000
00111100111111000000
00101101111111000000
00001111111111100100
00000111111111100010
00000111111111100011
00000011111111100001
00000111011111110001
00000110001101110001
00000100001101110011
00001100011000111110
00011100111000011100