20 20
XXOOOXXXXXXXXXXXXXXX
OOOXOOXXXXXXXXXXXXXX
OOOOOOXXXXXXXXXXXXXX
XXXOOOOXXXXXXXXXXXXX
OOOOOOOXXXXXXXXXXXXX
XXXXOOOOOXXXXXXXXXXX
XXXOOOOOOOOXXXXXXXXX
XXXOOOOOOOOOXXXXXXXX
XXXOOOOXOOOOOXXXXXXX
XXOOOOXXOOOOOOXXXXXX
XXOXOOXOOOOOOOXXXXXX
XXXXOOOOOOOOOOOXXOXX
XXXXXOOOOOOOOOOXXXOX
XXXXXOOOOOOOOOOXXXOO
XXXXXXOOOOOOOOOXXXXO
XXXXXOOOXOOOOOOOXXXO
XXXXXOOXXXOOXOOOXXXO
XXXXXOXXXXOOXOOOXXOO
XXXXOOXXXOOXXXOOOOOX
XXXOOOXXOOOXXXXOOOXX