20 20
00000000000000111100
00000000000001101010
00000000000011100111
00000000001111111111
00000000011001111011
00000000111100110010
00000001111110110000
00000011111110110000
00000011111110100000
00000111111101100000
00000111111011000000
00001111110110000000
00001111101100111111
00011111111101111111
00111111110111100000
01110111011111000000
11001110001101000000
00001100011100000000
00001000110000000000
00000001100000000000
