20 20
 XXXXXXXXXXXXXXXXXXXXXXXXXXXXXXXXXXXXXXXX
XXXXXXXXXXXXXXXXXXXXXXXXXXXXXXXXXXXXXXXX
XXXXXXXXXOOOOXXXXXXXXXXXXOOOXXXXXXXXXXXX
XXXXXXXXOXXXXOOXXXXXXXXOOXXXOOXXXXXXXXXX
XXXXXXOOOOOOOOXOOOOOOOOXOOOOOOOOXXXOXXXX
XXXXXXOXXXXXOXXXXXXXXXXXOOXXXXOOXXOOXXXX
XXXXXXOXXXOOXOOXXXXXXXXOXXOOXXOOXXOXXOXX
XXXXXXXOOOOXXXXXOOOOOXXXXXXOOOXXOXXOOOXX
XXXXXXXXXOOOXXXXOOOOOXXXXXOOOXXXXXXXXXXX
XXXXXXXXXXXXOOOOOOOOXOOOOOXXXXXOOXXXXXXX
XXXXXXXXXOOOXXXXOOOOOXXXOOOOOOOXOOXXXXXX
XXXXXXXOOXXXXXXXXXXXXXXXXXXXXOOXOXXXXXXX
XXXXXOOXXOOOXXXOOXXXOXXXXOOOOOOOXXXXXXXX
XXXOOXXXXXXOOXXOOXXXOXXXOOXOOXXXXXXXXXXX
XXXOXXXXXXXXOOXOOXXXXOOOXXXXOXXXXXXXXXXX
XXXOXXXXXXOOOOOOOOOXXXXOXXXXXXXXXXXXXXXX
XXXXOOOOOOOOOOOOXXXXOOOOOOXXXXXXXXXXXXXX
XXXXXXXXXXXXXXXXXXXXXXXXXXXXXXXXXXXXXXXX
XXXXXXXXXXXXXXXXXXXXXXXXXXXXXXXXXXXXXXXX
XXXXXXXXXXXXXXXXXXXXXXXXXXXXXXXXXXXXXXXX