20 20
XXXXXXXXXXXXXXXOOXXX
XXXXXXXXXXXXXXXOOXXX
XXXXXXXXXXXXXXXXXXXX
XXXXXXXXXXXXXXXXXOXX
XXXXXXXXOOOOXXXXXXXX
XXXXXXXOOOOOOXXXXXOO
XXXXXXOOOOOOOOXXXOOX
XXXXXOOOOOOOOOOXXOOO
OOXXOOOOOOOOOOOOXOOO
OOOXOOOOOOOOOOOOOOOO
XOOOOOOOOOOOOOOOOOOO
XXOOOOOOOOOOOOOXXXXX
XXXXXOOOOOOOOOOXXXXX
XXOOOOOXXXXOOOOOXXXX
XOOOOOOXXXXXOOOOOXXX
XXOOOOXXXXXXXOOOOXXX
XXXXXXXXXXXOOOOOOXXX
XXXXXXXXXXOOOOOOOXXX
XXXXXXXXXOOOOOOOXXXX
XXXXXXXXXXOOOOOXXXXX