20 20
00000000000000011000
00000000000000011000
00000000000000000000
00000000000000000100
00000000111100000000
00000001111110000011
00000011111111000110
00000111111111100111
11001111111111110111
11101111111111111111
01111111111111111111
00111111111111100000
00000111111111100000
00111110000111110000
01111110000011111000
00111100000001111000
00000000000111111000
00000000001111111000
00000000011111110000
00000000001111100000