23 23
01111000011111000011110
00111101111111110111100
00111111111111111111100
00011111111111111111000
00111111111111111111100
00111100011111000111100
00111000001110000011100
00110000000100000001100
00110000110101100001100
00110001101111010001100
00110001001110010001100
00011000110101100011000
00001100000100000110000
00000110001110001100000
00000011110001111000000
00000111111011111100000
00001111111111111110000
00011111111111111111000
00011111111111111111000
00011111111111111111000
00001111111111111110000
00000111111111111100000
00000010111111101000000