10 10
 OOOOOOOOOOOOOOOOOOOOOOOO
OOXXXXXOOOOOOOOOOXXXXXOO
OOOOXXXXXXXXXXXXXXXXOOOO
OOOOXXXXXXXXXXXXXXXOOOOO
OOOOXXXOOXXXXXOOOXXOOOOO
OOOOXXXXXOOOOOXXXXXOOOOO
OOOOXXXXXXXXXXXXXXXOOOOO
OOOOXXXXXXXXXXXXXXXXOOOO
OOXXXXXXXXXXXXXXXXXXXXOO
OOOOOOOOOOOOOOOOOOOOOOOO