25 25
0000000000000000000010000
0000000000000000000100000
0011000000010000001100100
0001100000011000011111000
1111110000001111110000000
0001111110011100110000000
0000111111111000001000000
0001111111111111000000000
0011111110000110000000000
0011111110000000000000000
0000011111000000000000000
0000001111100000000000000
0000001111110000000000000
0000000111111111111100000
0000000111111111111110000
0000001111111111111111000
0000011111111111111111000
0001111111111111111111000
0011000100000000111110000
0010000010000000011111000
0001000011100000001111000
0001000000111100000101100
0000100000000000000100110
0000000000000000000100011
0000000000000000001100001