10 10
 XXXXXXXXXXXXXXXOOOOOXXXXX
XXXXXXXXXXXXXXXOOOOOOXXXX
XXXXXXXXXXXXXOOOOOOOOOXXX
XXXXXOOOOOOOOOOOOOOOOOXXX
OOOOOOOOOOOOOOOOOOOOOOOOO
XXXOOOOOOOOOOOOOOOOOXXXXX
XXXXXOOOOOOOOOOOOOXXXXXXX
XXXXXXXOOOOOOXXXXXXXXXXXX
XXXXXXXXOOOOOXXXXXXXXXXXX
XXXXXXXXXXOOOOOXXXXXXXXXX