8 8
01100110
11111111
11111111
11011011
11111111
01011010
00011000
00110000