8 8
XOOXXOOX
OOOOOOOO
OOOOOOOO
OOXOOXOO
OOOOOOOO
XOXOOXOX
XXXOOXXX
XXOOXXXX