15 15
XXXXXXOOXXXXXXX
XXXXXXXOOXXXXXX
XXXXOOOOOOOOOXX
XXOOOOOOOOOOXOX
XOOOOOOOOOOOOXO
OOOOOOOOOOOOOOO
OOOOOOOXOOXOOOO
OOOXXXXOOXXXOOX
OOXXXXXXXXXXXOX
OXXXXXXXXXXXXXX
OOXXXXXXXXXXXOO
XOXXXXXOOXOXOXO
XXXOOXOOXOXOOXX
XXOXXOOXOOXOOOX
OOOXOOOXOOOXOOO