8 8
11000011
11111111
01111110
01011010
01111110
01100110
00111100
00000000