15 15
XXXXXXXXXOOOXXX
XXXXXXXXOOOOOXX
XXXXXXXOOOOXOOO
XXXXXXXOOOOOOOX
XXXXXXXXOOOOOXX
XXXXXXXXXOOOXXX
XXXXXXXXOOOOOXX
OXXXXXOOOOOOOOX
OOOXXOOOXXXOOOX
OOOOOOOXOOOXOOX
XOOOOOXOOOOXOOX
XOOOOOOOOXXOOXX
XXOOOOOOOOOOXXX
XXXXOOXOOOXXXXX
XXXXXXOOOOOOXXX