10 10
XXOOOOXXXX
XOOXOOOXXX
OOOOXOOOXX
OXOOOXOOXX
OOOOOXOOXX
OOOOXOOXXX
OOOOOOOXOX
OOOOOOXXXO
XOOOOOOOOO
OOOOOOOOOX 