15 15
XXXXOXOXXXXOXOX
XXOXOOOXXOXOOOX
XXXOOOOOXXOOOOO
XXXXOXOOXXXOXOO
XXXXOXXXXXXOXXX
XXXOOXXXXXOOXXX
XXXOOXXXXXOOXXX
XXOOXXXXXOOXXXX
XXOOXXXXXOOXXXO
OOOXXXOOOOXXOOO
OOOXOOOOOOXOOOO
OOXXOOOOOXXOOOO
XOOXOOOOOOXXOXO
XXOXOOXOXOXXXXO
XXOXOXXOXOXXOOO