10 10
0011000110
0100101001
0101111101
0011010110
0001111100
0011101110
1011111111
1011111111
1011111111
0111111110