10 10
0011110000
0110111000
1111011100
1011101100
1111101100
1111011000
1111111010
1111110001
0111111111
1111111110 