10 10
 XXXXXOXXXXXXXXOXXXXX
XXXXOOOOXXXXOOOOXXXX
XXXXOOOOOOOXXOOOXXXX
OOXXXOOXXXXXXOOOXXOX
XXOXXXXXXXXXXXOOOOXX
XXXXOXXXXXXXXXXOXXXX
XXXXOXXXXXXXXXXOXXXX
XXXOXXXOXXXXOXXXOXXX
XXXOOXXXXXXXXXOOOXXX
XXXXXXOOOOOOOOXXXXXX