13 13
0000000110000
0000001111000
0000001111110
0011100111111
0111110011000
1111111110000
1111111111000
0111111111000
0011111110000
0000011000000
0001111000000
0001010000000
0000111100000