13 13
XXXXXXXOOXXXX
XXXXXXOOOOXXX
XXXXXXOOOOOOX
XXOOOXXOOOOOO
XOOOOOXXOOXXX
OOOOOOOOOXXXX
OOOOOOOOOOXXX
XOOOOOOOOOXXX
XXOOOOOOOXXXX
XXXXXOOXXXXXX
XXXOOOOXXXXXX
XXXOXOXXXXXXX
XXXXOOOOXXXXX