13 13
0000000000000
0011000000000
0111100000000
1111100000000
0011100000000
0011100000000
0111000000000
0110000000000
1110001000111
1100011100101
1101111111001
1111111111111
0111011101110