8 10
00100000
00110000
00111000
00111000
00111000
00110000
00100000
00100000
00100000
00100000