10 10
0000010000
0000100000
0111111110
1100000011
1001000101
1011101111
1000000001
1001011101
1100111011
0111111110