10 10
0001111000
0010000100
0100000010
1010001001
1011001101
1000000001
1000000001
1000000001
1010101011
0101010101