10 10 
 XXXXXXXXXX
XXXXXXOXXX
XXXXXOXXXX
XXXOXOXXXX
XXXXXOXXXX
XXXXXOXXXX
XXXOXOXXXX
XXXXXOXXXX
XXXXXXOXXX
XXXXXXXXXX