10 10
 XXXXXXXXXX
XXXXXXOOXX
XXXXXXXOXX
XOXXXXXXOX
XXXXOXXXOX
XXXXXXXXOX
XOXXXXXOOX
XXXXXXXOXX
XXXXXXOXXX
XXXXXXXXXX