15 8
000000000110000
000000000100010
000000011000110
000000110111000
000001001100000
000010110000000
001101000000000
010100000000000