8 6
11111111
01101110
00110100
00011000
01001000
00010010