10 10
 OOXXXOOOOOOOOOOOOXXXOO
OOXXXXXXOOOOOOXXXXXXOO
OOXXXXXXXXXXXXXXXXXXOO
XXXXXOOXXXXXXXXOOXXXXX
XXXXXOOOXXXXXXOOOXXXXX
OOXXXXXXXXXXXXXXXXXXOO
XXXXXXXXXXXXXXXXXXXXXX
XXXXXXXXXXXXXXXXXXXXXX
OOXXXXXXXXXXXXXXXXXXOO
OOXXXOOXXXXXXXXOOXXXOO