10 10
 XXXOOOXXXXXOOOXXX
XXXOOOXXXXXOOOXXX
OOOXOOXXXXXOOXXOO
OOXXOOOOOOOOOOXOO
OOOOOOOOOOOOOOOOO
XXXOOOOOOOOOOOXXX
XXXOOOOOOOOOOOXXX
XXXXXXOOOOOXXXXXX
XXXXXXXXXXXXXXXXX
XXXXXXXXOXXXXXXXX