10 10
XXOOXXXOOX
XOXXOXOXXO
XOXOOOOOXO
XXOOXOXOOX
XXXOOOOOXX
XXOOOXOOOX
OXOOOOOOOO
OXOOOOOOOO
OXOOOOOOOO
XOOOOOOOOX