12 15
000011110000
000111111000
000111111000
000110011000
000110001100
001100001100
001100000100
001100000100
001100000100
001100000100
001100000100
001100000100
001100000100
001100001100
000111111000