15 15
000111000011100
001000100100010
000000000000000
001111100111110
101000100100010
011010111101011
001010100101010
001111100111110
000000000000000
000000000000000
000011111111100
000010101010100
000001101011000
000000111110000
000000000000000