15 15
000000000000000
000000000000000
001111000011110
010000100100001
010110000101100
010101000101010
010001000100010
001110000011100
000000000000000
000000111100000
000001000010000
000010000001000
000001000010000
000000111100000
000000000000000