15 15
011110000011110
110011000110011
100001000100001
000000000000000
111111111111111
011111111111110
011111111111110
011111111111110
001111000111100
000110000011000
000000000000000
001000000000100
001000000000100
000100000001000
000011111110000