15 15
000000000000000
000000000000000
000000000000000
000011000011000
000111100111100
000011000011000
000000000000000
000000000001000
000000000001000
000000000011100
000000000011100
000000000001000
000001000010000
000000111100000
000000000000000