15 15 
 XXXXXXXXXXXXXXX
XXXXXXOOOXXXXXX
XXXXOOOOOOOXXXX
XXXOOOOOOOOOXXX
XXXOOOOOOOOOXXX
XXOOOOOOOOOOOXX
XXOOOOOOOOOOOXX
XXOOOOOOOOOOOXX
XXOOOOOOOOOOOXX
XXOOOOOOOOOOOXX
XXXOOOOOOOOOOOX
XXXXOOOOOOOOOXX
XXXXOOOOOOOOXXX
XXXXXXOOOXXXXXX
XXXXXXXXXXXXXXX