15 15 
 XXXXXXXXXXXXXXX
XXXXXOOOOOXXXXX
XXXXOOXXXOOXXXX
XXXOXXXXXXXOXXX
XXOXXXXXXXXXOXX
XXOXOOOXOOOXOXX
XXOXOOOXOOOXOXX
XXOXOOXXOOOXOXX
XXOXXXXOXXXXOXX
XXXOXXOOOXXOXXX
XXXXOXXXXXXXXXX
XXXXOXOXXOXXXXX
XXXXOXOOXOXXXXX
XXXXXOOOOOXXXXX
XXXXXXXXXXXXXXX