15 15
000000011001010
000000111101010
000000111110000
000001111111011
000001101011101
000011111011110
000011101011111
000111101111111
000111101011111
001111111111100
001111111111100
101111111100000
011111100000000
111111100000000
011000000000000