15 15
 XXXXXXXXXXXXXXXXXXXX
XXXXXXXXXXXXXXXXXXXX
XXXXXXXXXXXXXXXXXXXX
XXXXXXXXXXXXXXXXXXXX
XXXXXXXXXXXXXXXXXXXX
XXXXXXXXXXXXXXXXXXXX
XXXXXXXOXXXXXOXXXXXX
XXXXXXOOXXXXOOXXXXXX
XXXXXXOOXXXXOOXXXXXX
XXXXXXXXXXXXXXXXXXXX
XXXXXXXXXXXXXXXXXXXX
XXXXXOOXOOOOXOOXXXXX
XXXXXOOXOOOOXOOXXXXX
XXXXXOOXOOOOXOOXXXXX
XXXXXXXXOOOOXXXXXXXX
XXXXXXXXOOOOXXXXXXXX
XXXXXXXXOOOOXXXXXXXX
XXXXXXXXXXXXXXXXXXXX
XXXXXXXXXXXXXXXXXXXX
XXXXXXXXXXXXXXXXXXXX