15 15
 XXXXXXOOOXXXXXX
XXXXOOXXXOOXXXX
XXXOXXXXXXXOXXX
XXOXXXXXXXXXOXX
XOXXXXXXXXXXXOX
XOXXOOXXXOOXXOX
OXXXXXXXXXXXXXO
OXXXXXXXXXXXXXO
OXXXOOOOOOOXXXO
XOXXOXXXXXOXXOX
XOXXXXXXXXXXXOX
XXOXXXOOOXXXOXX
XXXOXXXXXXXOXXX
XXXXOOXXXOOXXXX
XXXXXXOOOXXXXXX