15 15
OOXOOXXXXXXOOXO
OOXOOXOXXOXOOXO
XOOOOXOXXOXOOXO
XXOOOOOXXXOOOOO
XXXXOOXOOOOOXXX
XXXXXXOOOOOOOXX
XXXXXOXOXOOOOOX
XXXXOOOOOOOOOOO
XXXOOOOOOOOOOOO
XXOOOOOOOOOOOOO
XOOOOOOOOXOOOOO
XOXOOOXXXXOOOOO
XOOOOOXXXXOOOOO
XXOOOXXXXOOOOOO
XXXXXXXXXOOOOOO