15 15
XXXXXXXXXXXXOOO
XXXXXOOOOXXOOXO
XXXOOOXXOXXOXOX
OOOXOXXOOXXOXXX
OOXXXXXOXXXOOXX
XOOOOXXOOXXXOOX
XXXXOOXXOOXXXOO
XXXXXOXXXOOOXXO
XXXXXOOXXXXOOXO
XXXOOOOXXXXXOOO
XXXOXOXXOOXXXOO
XXXXXOXXOXXXXOX
XXXXXXOXOXXXXOX
XXXXXOOOOOXXOOX
XXXOOOXOOXOOOXX