12 8
000000000011
000000001111
000000111110
000001110110
110001100110
111111001100
011000111000
001111100000