22 17
0000000000001111111000
0000000000001011111000
0000000000001111101000
0000000000010111101000
0000000000011111101100
0000000000101111110110
0000000001111111111010
0000001110111111111010
0111111111111111111110
1111111111111111111100
1111111111111100000000
0111111110000011111100
0000000001111101111100
0011111110000001111100
0011000110000000011000
0011100110000000011000
0001111111111111111111
