15 17
111000000000000
101000000000000
111000000000000
000111111100000
000010101000000
000101010100000
000010101000000
000111111100000
000011111000000
000011111000000
000011111000000
000011111000000
000011111100000
000011111111110
000010111111011
000001011111101
000010111111010