15 20
000000010000000
000000111000000
000001000100000
000001101100000
000000111000000
000001101100000
000011100110000
000111000011000
000111000001000
000110000001100
001110000000100
001110000000100
001100000000100
001111110000100
011111111100110
111110000000001
111111111111111
000000101000000
000000111011100
000000011110111