15 20
000000100000000
000000110000000
000001110000000
000011011000000
000010011100000
000110101110000
000100110110000
001101110111000
001101101011000
001101101011000
000110110011000
000011010110000
000000010000000
000000111000000
000001111100000
011101111101100
111001111100111
111001111000111
011110000011110
000111111111000