15 25
000000000110000
000111111110000
001111110000000
001111111100000
011111111110000
011111111110010
011111111110111
011000000110111
010010001010010
111000100011010
111111011111010
011111111110010
110111111011110
110011110011110
111100000010010
011100000010010
001111100010010
011111110010010
111111110011010
111111110001010
111111100001010
011111111111010
000011011000010
001111011110000
001111011110000