15 25
000000001000000
000000011100000
000000110110000
000000011100000
000000001000000
000000011100000
000001110111000
000000001110000
000000111100000
000011110111100
000000001110000
000000111100000
000011110001100
000111000111000
001100011100000
000001111000000
000111100001110
011110000111000
110000011100000
000001111000000
001111000011110
111111111111111
000000011000000
000000011000000
000000011000000