15 25
000000000001100
000000001100110
000011100111011
000000111011101
000000011111111
000011111111111
000110011101101
000001110011011
000001100110111
000000100001110
000001110011000
000001110000000
000011111100000
001111111110000
011111111111000
011111111111000
111101110111100
101010101010100
110111011101100
011111111111000
101101110110100
010010101001000
011111011111000
001111111110000
000011111000000