17 20
00111000000011100
01111100000111110
11100110001100111
11110011011001111
01111110111111110
00000011110000000
00001110011100000
00011100001110000
01111001100111100
11110111111011110
00001111111100000
00011111111110000
00111110011111000
00110101101011000
00101010010101000
00110101101011000
00011110011110000
00011111111110000
00001111111100000
00000011110000000