19 20
0000000000000011100
0000000000000110110
0000000000001101010
0000000000001011101
0000000000001111111
0011100000001101011
0110110001101010101
0101011001111100011
1011101001111010101
1111111000111101011
1101011000011111111
1010101011011011101
1100011111001101010
1010101111001110110
1101011110001111110
1111111100000000000
1011101100000000000
0101011000000000000
0110111000000000000
0111111000000000000