17 22
01000000000000000
11100000000000000
11100000000000000
01000000100000000
01111111110000000
00000000100000000
00000111111100000
00001111111110000
00011111111111000
00011111111111000
00000000000000000
11111111111111111
01111111111111110
01111111111111110
01111111111111110
01100000000000110
01101111111110110
01101111011110110
01101111111110110
01100000000000110
01111111111111110
11111111111111111