9 11
000010000
000010000
000111000
001011100
001011100
001011100
010111110
010111110
101111111
000001000
000000100