15 17
00111110000
01001111000
00011111000
00111111100
00110001100
00101010100
00100000100
00110101100
01100000110
11100000111
11110001111
11110001111
01011011010
00111111100
00111111100
00111111100
00111011100
01111011110