13 18
0110000000110
0010000100100
0011010101100
0011111111100
0011010101100
0111010101110
0110010100110
1110010100111
1110010100111
1110010100011
1100010100011
1100111110011
1110010100111
0111111111110
0011111111100
0000111110000
0000111110000
0011111111100