15 15
000100001000000
000010000100000
000100001000000
001000010000000
000100001000000
000000000000000
011111111110000
011111111111110
011111111111111
011111111110011
001111111110011
001111111111110
001111111101100
000111111000000
000011110000000
