13 9
0000001000000
0000111110000
0001111111000
0000111110000
0111111111110
1111111111111
1111111111111
1111111111111
1111111111111